илллллллллллАААлииииииииииииил
 илААААА$АААлАлАлАААААААААААААл
илА$ААААААлАлАлААА$ААА$ААААл
лллллААВААААВАлАлАлАААААААВААААл
АААААААА$АААлАлАлАВААВВААААВАл
лллллА$ААААААлАлАлАААААВААААААл
 $иилАААААВАААлАлААлАААААААААААл
иилААААА$ААлАлААлАААА$АААА$ААл
иилАААААААААлАллАлАА$АААААААААл
 иллллллллААлААлАлААААллллллллл
иии лАлллАлАлААААлииииииии
  $иилАлллАлАлААААл 
$ии А$АААлАллллАл   
 илллллллААААААл     