ииииииииииииииии 
мммммммммммммммм 
АААААВААААААААлл
АААААЯААААААЯААл
ЯААААААААЯАААААл
ВВВВВВВВВААААААлл
пппппппппппппппп 
ииииииииииииииии 
  
