илллллллллллллллли
лААААААААААААААААли
лААААААААААААААААли
лАААВВВВВВВВВААААли
лААААААААААААААААли
лААВАААААААААВАААли
лАААААААААААААААли
лАААВВВВВВВВВААААли
лААААААААААААААААли
илллллллллллллллли
ииииииииииииииии 
