ллл
л  лллБлл л           л
л  лЯлБл  л  ВВ  ВВ   л
л  лАлБл  л  В    В   л
л  лАлл  л          л
л  лАлБл  л  В    В   л
л  лАлБл  л  ВВЯЯВВ   л
л лАлБл  лл ЯЯЯЯЯЯ  л
ллллАлБл     ЯЯЯЯЯЯ   л
ЯЯЯЯЯЯЯлиииииииииииииил
ллллллллллллллллллллллл
<@> "Ground= "