€€€€€€€€€€€€€€€€€€€€€€€€€€€
∞∞∞∞∞∞∞∞∞∞∞∞∞∞∞∞∞∞∞∞∞∞∞∞∞€
€€€€€€€€€€€€€€€€€€€€€€€€€∞€
∞∞∞∞∞∞∞∞∞∞∞∞∞∞∞∞∞∞∞∞∞∞∞∞∞∞€
€ﬂ€€€€€€€€€€€€€€€€€€€€€€€€€
∞∞∞∞∞∞€∞∞∞∞∞∞∞∞∞∞∞∞∞∞∞∞∞∞∞€
€€€€€ﬂ€€€€€ﬂ€€€€€€€‹€€€€€€€
∞∞∞∞∞∞∞∞∞∞∞∞∞∞∞∞∞∞€∞∞∞∞∞∞∞€
€€€€€€€€€€€€€€€€€€€€€€€ﬂ€€€
∞∞∞∞∞∞∞∞∞∞∞∞∞∞∞∞∞∞∞∞∞∞∞∞∞∞€
∞€€€€€€€€€€€€€€€€€€€€€€€€€€
 €
€                     €
€  ≤    ≤     ≤     ≤  €
€                     €
€€
€€€€€€€€€€€€€€€€€€€€€€€€€€€
<@> "Ground= "