лллллллллллллллллллллллллллллл
лБАААААААААААААААААААААААААпл
лБ                           л
лБ ииииииииииииииииии л
лБ                           л
лБ       ЩФФФФФФФФФФЛ        л
лБ       ГГ        л
лБ       ГГ        л
лБ       ГГ        л
лБ       ГГ        л
лБ       ШФФФФФФФФФФМ        л
лБл
лБл
лБ                           л
лллллллллллллллллллллллллллллл
;<@> tootal=27 *2 enemies =54